R 1200 800

NO ./TEXTURE/1ya.xpm
SO ./TEXTURE/2ya.xpm
WE ./TEXTURE/3ya.xpm
EA ./TEXTURE/4ya.xpm
S2 ./TEXTURE/711.xpm
S3 ./TEXTURE/book.xpm
S4 ./TEXTURE/door_secret.xpm

F 181, 143, 116
C 157, 224, 215

11111111111111111111111111111111111111111111 1111111111111111111111111111
11000000000100000000002000000000000000000011110011100010010000001111
10000000000000000000000000200000000000000000040001000000010020000111
13101211000100000200000000000000111111111111010000000000000000000011
111111111111111111111111011111111          1010000003000000000000001
       11111111111111111011000011   11111111011100000000000300020011
       11000000000110100000000031   12300004010000003000000000000001
        1011000001110000000000211   11111111311110000000020000001111
        1001000000000000000000001          1010000000000000000000001
111111111011000001110100000000121          1310010000101010101111111
100000000011000001111114111111111          1010010100000000002000001
11110111111111011100000010001              13100101001000000000030W1
11110111111111011101013010001              101111111111111111111111111111
11000000110101011100003000001              131
10000000000020001100303010001              101
10111011011100000401010010031              131
10000000000000021111111111111              101
10111001011100001                          131
10000011100000001                          101
10000001000020001                          131
10000000000000001                          101
11300001110101011                          131
11110111 1110101                           101
11111111 1111111                           131
                                           111 