 R 800 400

 NO ./TEXTURE/1ya.xpm
 SO ./TEXTURE/2ya.xpm
WE ./TEXTURE/3ya.xpm
EA ./TEXTURE/bk.xpm
S ./TEXTURE/711.xpm

F 181, 143, 116
C 157, 224,

111111111
100N00001
100000001
111111111
