 R 14000 8000

 NO ./TEXTURE/1ya.xpm
 SO ./TEXTURE/2ya.xpm
WE ./TEXTURE/3ya.xpm
EA ./TEXTURE/bk.xpm
S ./TEXTURE/711.xpm

F 181, 143, 116
C 157, 224,

11111111111111111111111111111111111111111111 1111111111111111111111111111
11000000000100000000002000000000000000000011110011100010010000001111
10000000000000000000000000200000000000000000000001000000010020000111
10101211000100000200000000000000111111111111000000000000000000000011
111111111111111111111111011111111          1010000000000000000000001
       11111111111111111011000011   1111   1011100000000000000020011
       11000000000110100000000001   101    1010000000000000000000001
        1011000001110000000000211   1111   1011110000000020000001111
        10010W0000000000000000001          1010000000000000000000001
111111111011000001110100000000121          1010010000101010101111111
100000000011000001110111111111111          1010010100000000002000001
11110111111111011100000010001              1010010100100000000000001
11110111111111011101010010001              101111111111111111111111111111
11000000110101011100000000001              101
10000000000020001100000010001              101
10111011011100001101010010001              101
10000000000000021111111111111              101
10111001011100001                          101
10000011100000001                          101
10000001000020001                          101
1000000000000000111111111111111111         101
1100000111010101111101111000111            101
11110111 1110101 101111010001              101
11111111 1111111 111111111111              101
                                           111 