R 1920 1080

NO ./TEXTURE/1ya.xpm
SO ./TEXTURE/2ya.xpm
WE ./TEXTURE/3ya.xpm
EA ./TEXTURE/bk.xpm
S ./TEXTURE/711.xpm

F 90,170,70
C 70,150, 150

1111111111111111111111111111111111111111111
1S00000000100000000000000012000000100000001
1010100000100101010100000010000100100000001
1010100000100000000000000010001100100000001
1010111000100101010100000011111100111111101
1010021000100000000000000000000000120000001
1010111000100101010100000000000000111110001
1000100000000000000000000000000000000000111
1111111111111111111111111111000001111111111
1000000000000000000000000000000000000000001
1000100000000000000000000000111111101111111
1001110000000000000000002000100000001000001
1000100000000000000000000000101101111111101
1000000000000000200000000000101001000000001
1000100000000111111100000000101000011111101
1001010000100011111000100200101111110000001
1200100001110001110001110000100001000111111
1000000011111000100011111000111101011111111
1000000111111100200111111100100001000000001
1200000000000000000000000000100111000000001
1111111111111111111111111111111111000200011
111111111111111111111111111111111100222001
111111111111111111111111111111111102222201
111111111111111111111111111111111122222221
                                 111111111